ACCIO	AE K IY OW
AGUAMENTI	AE G W AH M EH N T IY
ALARTE	AE L AH R T
ALOHOMORA	AE L AH HH AA M AH R AH
ANAPNEO	AH N AE P N IY OW
APERIO	AH P IY R IY OW
APPARATE	AE P AH R EY T
ASCENDARE	AE S EH N D AH R
ASCENDIO	AE S EH N D IY OW
AVADA	AE V AH D AH
AVIFORS	AE V AH F AH R Z
AVIS	AE V IH S
AVIS	EY V IH S
BAUBILIOUS	B AH B IH L IY AH S
BESTIO	B IH S T AY OW
BOMBARDA	B AA M B AA R D AH
CISTEM	S IH S T AH M
COLLOPORTUS	K AA L AH P AO R T AH S
CONFRINGO	K AA N F R IH N G OW
CRUCIO	K R UW S IY OW
DEFODIO	D AH F OW D IY OW
DEPULSO	D AH P UH L S OW
DIFFINDO	D IH F IH N D OW
DISILLUSIO	D AH S IH L UW S IY OW
DURO	D UH R OW
EPISKEY	AH P IH S K IY
EVANESCO	EH V AH N EH S K OW
EXPECTO	IH K S P EH K T OW
EXPELLIARMUS	IH K S P EH L IY AA R M AH S
EXPULSO	IH K S P UH L S OW
FERA	F EH R AH
FINITE	F IH N IY T EY
FLIPENDO	F L IH P AH N D OW
FUMOS	F UW M AH Z
GLISSEO	G L IH S IY OW
HERBIVICUS	HH AH R B AH V IH K AH S
HOMENUM	HH AA M AH N AH M
IMPERIO	IH M P AH R AY OW
INCANTATEM	IH N K AE N T AH T AH M
INCENDIO	IH N S EH N D IY OW
KEDAVRA	K AH D AE V R AH
LEVIOSA	L IY V IY AH S AH
LUMOS	L UW M OW S
MAXIMA	M AE K S AH M AH
MELOFORS	M EH L AH F AH R Z
MORSMORDRE M AO R S M AO R D R EY
MULTICOLORFORS	M AH L T AY K AH L ER F AO R Z
NOX	N AA K S
OBLIVIATE	AA B L IH V AY EY T
OBSCURO	AA B S K Y AH R OW
ORCHIDEOUS	AO R CH IH D IY AH S
PATRONUM	P AE T R AH N AH M
PETRIFICUS	P EH T R AH F IH S AH S
PORTUS	P AO R T AH S
PROTEGO	P R OW T EH G OW
REFULGENS	R AH F UH L JH AH N Z
REVELIO	R AH V IY L IY OW
STUPEFY	S T UW P AH F AY
TOTALUS	T OW T AH L AH S
VERTO	V AH R T OW
WINGARDIUM	W IH N G AA R D IY AH M
